R       30001112312381841 400
NO      ./textures/red.xpm
SO ./textures/red.xpm
EA ./textures/red.xpm
WE ./textures/purplestone.xpm

S ./textures/tonneau.xpm
F  000, 000,00
C 255  ,20 ,30

        111111111            
        1 000000             
111111111000200000000000011111
100000000000000000111000000001
110000100000000000000000001111
100001111111000000020000111111
111111100000000000000000000001
111100000000001100000002000011
110000000000011110000W00000011
100000000000111000000000000011
110000000000111000000000001111
110000000001111000000000000111
1111111111111111111111111111 
